##############
#            #                                                #######
#   #  ##### #                                                #  B  #
#   #  #  ## #                                                #     #
## ###### #  #                                                ### ###
#   #     ## #                                                  # #
# ### ##  #  #                                                  # #
#   #  # ### #################################################### #
#   #  #                                                          #
# ########### #####################################################
# #       # # #
# #       # # #####################################################
# ######### ###                                                   #
# #     #   #   ################################################# #
#     # # # # ###                                               # #
##### # # #   #                                               ### ###
#     # # #####                                               #     #
#####     #                                                   #  A  #
    #######                                                   #######