##############
#   #        #
# A #  ##### #
#      #  ## #
######### #  #
#         ## #
# ######  #  #
#   #  # ### #
#   #        #
##############
