##############
#   #        #
# A #  ##### #
#   #  #  ## #
######### #  #
#        B## #
# ######  #  #
#   #  # ### #
#   #        #
##############
